111111111
100000C01
10P000001
10C000E01
100000001
100000001
111111111